,month,interest,principal,loan balance,total_interest,monthly_payment
0,1.0,716.95,599.46,327750.0,716.95,1316.41
1,2.0,715.64,600.77,327150.54,1432.5900000000001,1316.41
2,3.0,714.33,602.08,326549.76999999996,2146.92,1316.41
3,4.0,713.01,603.4,325947.68999999994,2859.9300000000003,1316.41
4,5.0,711.69,604.72,325344.2899999999,3571.6200000000003,1316.41
5,6.0,710.37,606.04,324739.56999999995,4281.990000000001,1316.41
6,7.0,709.04,607.37,324133.52999999997,4991.030000000001,1316.41
7,8.0,707.71,608.7,323526.16,5698.740000000001,1316.41
8,9.0,706.38,610.03,322917.45999999996,6405.120000000001,1316.41
9,10.0,705.05,611.36,322307.42999999993,7110.170000000001,1316.41
10,11.0,703.71,612.7,321696.06999999995,7813.880000000001,1316.41
11,12.0,702.37,614.04,321083.36999999994,8516.250000000002,1316.41
12,13.0,701.03,615.38,320469.32999999996,9217.280000000002,1316.41
13,14.0,699.68,616.73,319853.94999999995,9916.960000000003,1316.41
14,15.0,698.33,618.08,319237.22,10615.290000000003,1316.41
15,16.0,696.98,619.43,318619.13999999996,11312.270000000002,1316.41
16,17.0,695.62,620.79,317999.70999999996,12007.890000000003,1316.41
17,18.0,694.27,622.14,317378.92,12702.160000000003,1316.41
18,19.0,692.91,623.5,316756.77999999997,13395.070000000003,1316.41
19,20.0,691.54,624.87,316133.27999999997,14086.610000000004,1316.41
20,21.0,690.17,626.24,315508.41,14776.780000000004,1316.41
21,22.0,688.8,627.61,314882.17,15465.580000000004,1316.41
22,23.0,687.43,628.98,314254.56,16153.010000000004,1316.41
23,24.0,686.06,630.35,313625.58,16839.070000000003,1316.41
24,25.0,684.68,631.73,312995.23000000004,17523.750000000004,1316.41
25,26.0,683.3,633.11,312363.50000000006,18207.050000000003,1316.41
26,27.0,681.91,634.5,311730.3900000001,18888.960000000003,1316.41
27,28.0,680.52,635.89,311095.8900000001,19569.480000000003,1316.41
28,29.0,679.13,637.28,310460.00000000006,20248.610000000004,1316.41
29,30.0,677.74,638.67,309822.72000000003,20926.350000000006,1316.41
30,31.0,676.34,640.07,309184.05000000005,21602.690000000006,1316.41
31,32.0,674.94,641.47,308543.98000000004,22277.630000000005,1316.41
32,33.0,673.54,642.87,307902.51000000007,22951.170000000006,1316.41
33,34.0,672.13,644.28,307259.6400000001,23623.300000000007,1316.41
34,35.0,670.72,645.69,306615.36000000004,24294.020000000008,1316.41
35,36.0,669.31,647.1,305969.67000000004,24963.33000000001,1316.41
36,37.0,667.89,648.52,305322.57000000007,25631.22000000001,1316.41
37,38.0,666.47,649.94,304674.05000000005,26297.69000000001,1316.41
38,39.0,665.05,651.36,304024.11000000004,26962.74000000001,1316.41
39,40.0,663.63,652.78,303372.75000000006,27626.37000000001,1316.41
40,41.0,662.2,654.21,302719.97000000003,28288.57000000001,1316.41
41,42.0,660.77,655.64,302065.76,28949.34000000001,1316.41
42,43.0,659.33,657.08,301410.12,29608.670000000013,1316.41
43,44.0,657.9,658.51,300753.04,30266.570000000014,1316.41
44,45.0,656.46,659.95,300094.52999999997,30923.030000000013,1316.41
45,46.0,655.01,661.4,299434.57999999996,31578.04000000001,1316.41
46,47.0,653.57,662.84,298773.17999999993,32231.61000000001,1316.41
47,48.0,652.12,664.29,298110.3399999999,32883.73000000001,1316.41
48,49.0,650.66,665.75,297446.04999999993,33534.390000000014,1316.41
49,50.0,649.21,667.2,296780.29999999993,34183.60000000001,1316.41
50,51.0,647.75,668.66,296113.0999999999,34831.35000000001,1316.41
51,52.0,646.28,670.13,295444.43999999994,35477.63000000001,1316.41
52,53.0,644.82,671.59,294774.30999999994,36122.45000000001,1316.41
53,54.0,643.35,673.06,294102.7199999999,36765.80000000001,1316.41
54,55.0,641.88,674.53,293429.6599999999,37407.68000000001,1316.41
55,56.0,640.4,676.01,292755.1299999999,38048.08000000001,1316.41
56,57.0,638.92,677.49,292079.1199999999,38687.00000000001,1316.41
57,58.0,637.44,678.97,291401.6299999999,39324.44000000001,1316.41
58,59.0,635.96,680.45,290722.6599999999,39960.40000000001,1316.41
59,60.0,634.47,681.94,290042.2099999999,40594.87000000001,1316.41
60,61.0,632.98,683.43,289360.2699999999,41227.85000000001,1316.41
61,62.0,631.48,684.93,288676.8399999999,41859.330000000016,1316.41
62,63.0,629.98,686.43,287991.9099999999,42489.31000000002,1316.41
63,64.0,628.48,687.93,287305.4799999999,43117.79000000002,1316.41
64,65.0,626.98,689.43,286617.54999999993,43744.770000000026,1316.41
65,66.0,625.47,690.94,285928.11999999994,44370.24000000003,1316.41
66,67.0,623.96,692.45,285237.17999999993,44994.200000000026,1316.41
67,68.0,622.44,693.97,284544.7299999999,45616.64000000003,1316.41
68,69.0,620.92,695.49,283850.75999999995,46237.56000000003,1316.41
69,70.0,619.4,697.01,283155.26999999996,46856.96000000003,1316.41
70,71.0,617.88,698.53,282458.25999999995,47474.840000000026,1316.41
71,72.0,616.35,700.06,281759.7299999999,48091.190000000024,1316.41
72,73.0,614.82,701.59,281059.6699999999,48706.010000000024,1316.41
73,74.0,613.28,703.13,280358.0799999999,49319.29000000002,1316.41
74,75.0,611.75,704.66,279654.9499999999,49931.04000000002,1316.41
75,76.0,610.2,706.21,278950.2899999999,50541.24000000002,1316.41
76,77.0,608.66,707.75,278244.0799999999,51149.90000000002,1316.41
77,78.0,607.11,709.3,277536.3299999999,51757.010000000024,1316.41
78,79.0,605.56,710.85,276827.0299999999,52362.57000000002,1316.41
79,80.0,604.0,712.41,276116.17999999993,52966.57000000002,1316.41
80,81.0,602.45,713.96,275403.76999999996,53569.02000000002,1316.41
81,82.0,600.88,715.53,274689.80999999994,54169.900000000016,1316.41
82,83.0,599.32,717.09,273974.2799999999,54769.220000000016,1316.41
83,84.0,597.75,718.66,273257.1899999999,55366.970000000016,1316.41
84,85.0,596.18,720.23,272538.5299999999,55963.150000000016,1316.41
85,86.0,594.6,721.81,271818.29999999993,56557.750000000015,1316.41
86,87.0,593.02,723.39,271096.48999999993,57150.77000000001,1316.41
87,88.0,591.44,724.97,270373.0999999999,57742.210000000014,1316.41
88,89.0,589.86,726.55,269648.12999999995,58332.070000000014,1316.41
89,90.0,588.27,728.14,268921.57999999996,58920.34000000001,1316.41
90,91.0,586.67,729.74,268193.43999999994,59507.01000000001,1316.41
91,92.0,585.08,731.33,267463.69999999995,60092.09000000001,1316.41
92,93.0,583.48,732.93,266732.36999999994,60675.570000000014,1316.41
93,94.0,581.87,734.54,265999.43999999994,61257.44000000002,1316.41
94,95.0,580.27,736.14,265264.89999999997,61837.710000000014,1316.41
95,96.0,578.66,737.75,264528.75999999995,62416.37000000002,1316.41
96,97.0,577.04,739.37,263791.00999999995,62993.41000000002,1316.41
97,98.0,575.43,740.98,263051.63999999996,63568.84000000002,1316.41
98,99.0,573.8,742.61,262310.66,64142.64000000002,1316.41
99,100.0,572.18,744.23,261568.05,64714.82000000002,1316.41
100,101.0,570.55,745.86,260823.81999999998,65285.370000000024,1316.41
101,102.0,568.92,747.49,260077.96,65854.29000000002,1316.41
102,103.0,567.29,749.12,259330.47,66421.58000000002,1316.41
103,104.0,565.65,750.76,258581.35,66987.23000000001,1316.41
104,105.0,564.0,752.41,257830.59,67551.23000000001,1316.41
105,106.0,562.36,754.05,257078.18,68113.59000000001,1316.41
106,107.0,560.71,755.7,256324.13,68674.30000000002,1316.41
107,108.0,559.06,757.35,255568.43,69233.36000000002,1316.41
108,109.0,557.4,759.01,254811.08,69790.76000000001,1316.41
109,110.0,555.74,760.67,254052.06999999998,70346.50000000001,1316.41
110,111.0,554.07,762.34,253291.39999999997,70900.57000000002,1316.41
111,112.0,552.41,764.0,252529.05999999997,71452.98000000003,1316.41
112,113.0,550.74,765.67,251765.05999999997,72003.72000000003,1316.41
113,114.0,549.06,767.35,250999.38999999996,72552.78000000003,1316.41
114,115.0,547.38,769.03,250232.03999999995,73100.16000000003,1316.41
115,116.0,545.7,770.71,249463.00999999995,73645.86000000003,1316.41
116,117.0,544.01,772.4,248692.29999999996,74189.87000000002,1316.41
117,118.0,542.32,774.09,247919.89999999997,74732.19000000003,1316.41
118,119.0,540.63,775.78,247145.80999999997,75272.82000000004,1316.41
119,120.0,538.93,777.48,246370.02999999997,75811.75000000003,1316.41
120,121.0,537.23,779.18,245592.54999999996,76348.98000000003,1316.41
121,122.0,535.53,780.88,244813.36999999997,76884.51000000002,1316.41
122,123.0,533.82,782.59,244032.48999999996,77418.33000000003,1316.41
123,124.0,532.11,784.3,243249.89999999997,77950.44000000003,1316.41
124,125.0,530.39,786.02,242465.59999999998,78480.83000000003,1316.41
125,126.0,528.67,787.74,241679.58,79009.50000000003,1316.41
126,127.0,526.95,789.46,240891.84,79536.45000000003,1316.41
127,128.0,525.22,791.19,240102.38,80061.67000000003,1316.41
128,129.0,523.49,792.92,239311.19,80585.16000000003,1316.41
129,130.0,521.76,794.65,238518.27,81106.92000000003,1316.41
130,131.0,520.02,796.39,237723.62,81626.94000000003,1316.41
131,132.0,518.28,798.13,236927.22999999998,82145.22000000003,1316.41
132,133.0,516.53,799.88,236129.09999999998,82661.75000000003,1316.41
133,134.0,514.78,801.63,235329.21999999997,83176.53000000003,1316.41
134,135.0,513.03,803.38,234527.58999999997,83689.56000000003,1316.41
135,136.0,511.27,805.14,233724.20999999996,84200.83000000003,1316.41
136,137.0,509.51,806.9,232919.06999999995,84710.34000000003,1316.41
137,138.0,507.75,808.66,232112.16999999995,85218.09000000003,1316.41
138,139.0,505.98,810.43,231303.50999999995,85724.07000000002,1316.41
139,140.0,504.2,812.21,230493.07999999996,86228.27000000002,1316.41
140,141.0,502.43,813.98,229680.86999999997,86730.70000000001,1316.41
141,142.0,500.65,815.76,228866.88999999996,87231.35,1316.41
142,143.0,498.86,817.55,228051.12999999995,87730.21,1316.41
143,144.0,497.07,819.34,227233.57999999996,88227.28000000001,1316.41
144,145.0,495.28,821.13,226414.23999999996,88722.56000000001,1316.41
145,146.0,493.48,822.93,225593.10999999996,89216.04000000001,1316.41
146,147.0,491.68,824.73,224770.17999999996,89707.72,1316.41
147,148.0,489.88,826.53,223945.44999999995,90197.6,1316.41
148,149.0,488.07,828.34,223118.91999999995,90685.67000000001,1316.41
149,150.0,486.26,830.15,222290.57999999996,91171.93000000001,1316.41
150,151.0,484.44,831.97,221460.42999999996,91656.37000000001,1316.41
151,152.0,482.62,833.79,220628.45999999996,92138.99,1316.41
152,153.0,480.8,835.61,219794.66999999995,92619.79000000001,1316.41
153,154.0,478.97,837.44,218959.05999999997,93098.76000000001,1316.41
154,155.0,477.14,839.27,218121.61999999997,93575.90000000001,1316.41
155,156.0,475.31,841.1,217282.34999999998,94051.21,1316.41
156,157.0,473.47,842.94,216441.24999999997,94524.68000000001,1316.41
157,158.0,471.62,844.79,215598.30999999997,94996.3,1316.41
158,159.0,469.77,846.64,214753.51999999996,95466.07,1316.41
159,160.0,467.92,848.49,213906.87999999995,95933.99,1316.41
160,161.0,466.07,850.34,213058.38999999996,96400.06000000001,1316.41
161,162.0,464.21,852.2,212208.04999999996,96864.27000000002,1316.41
162,163.0,462.34,854.07,211355.84999999995,97326.61000000002,1316.41
163,164.0,460.47,855.94,210501.77999999994,97787.08000000002,1316.41
164,165.0,458.6,857.81,209645.83999999994,98245.68000000002,1316.41
165,166.0,456.72,859.69,208788.02999999994,98702.40000000002,1316.41
166,167.0,454.84,861.57,207928.33999999994,99157.24000000002,1316.41
167,168.0,452.96,863.45,207066.76999999993,99610.20000000003,1316.41
168,169.0,451.07,865.34,206203.31999999992,100061.27000000003,1316.41
169,170.0,449.18,867.23,205337.97999999992,100510.45000000003,1316.41
170,171.0,447.28,869.13,204470.7499999999,100957.73000000003,1316.41
171,172.0,445.38,871.03,203601.6199999999,101403.11000000003,1316.41
172,173.0,443.47,872.94,202730.5899999999,101846.58000000003,1316.41
173,174.0,441.56,874.85,201857.6499999999,102288.14000000003,1316.41
174,175.0,439.65,876.76,200982.7999999999,102727.79000000002,1316.41
175,176.0,437.73,878.68,200106.0399999999,103165.52000000002,1316.41
176,177.0,435.81,880.6,199227.3599999999,103601.33000000002,1316.41
177,178.0,433.88,882.53,198346.7599999999,104035.21000000002,1316.41
178,179.0,431.95,884.46,197464.2299999999,104467.16000000002,1316.41
179,180.0,430.02,886.39,196579.7699999999,104897.18000000002,1316.41
180,181.0,428.08,888.33,195693.3799999999,105325.26000000002,1316.41
181,182.0,426.14,890.27,194805.0499999999,105751.40000000002,1316.41
182,183.0,424.19,892.22,193914.7799999999,106175.59000000003,1316.41
183,184.0,422.24,894.17,193022.5599999999,106597.83000000003,1316.41
184,185.0,420.28,896.13,192128.3899999999,107018.11000000003,1316.41
185,186.0,418.32,898.09,191232.2599999999,107436.43000000004,1316.41
186,187.0,416.36,900.05,190334.1699999999,107852.79000000004,1316.41
187,188.0,414.39,902.02,189434.1199999999,108267.18000000004,1316.41
188,189.0,412.41,904.0,188532.09999999992,108679.59000000004,1316.41
189,190.0,410.44,905.97,187628.09999999992,109090.03000000004,1316.41
190,191.0,408.45,907.96,186722.12999999992,109498.48000000004,1316.41
191,192.0,406.47,909.94,185814.16999999993,109904.95000000004,1316.41
192,193.0,404.48,911.93,184904.22999999992,110309.43000000004,1316.41
193,194.0,402.48,913.93,183992.29999999993,110711.91000000003,1316.41
194,195.0,400.48,915.93,183078.36999999994,111112.39000000003,1316.41
195,196.0,398.48,917.93,182162.43999999994,111510.87000000002,1316.41
196,197.0,396.47,919.94,181244.50999999995,111907.34000000003,1316.41
197,198.0,394.46,921.95,180324.56999999995,112301.80000000003,1316.41
198,199.0,392.44,923.97,179402.61999999994,112694.24000000003,1316.41
199,200.0,390.42,925.99,178478.64999999994,113084.66000000003,1316.41
200,201.0,388.4,928.01,177552.65999999995,113473.06000000003,1316.41
201,202.0,386.37,930.04,176624.64999999994,113859.43000000002,1316.41
202,203.0,384.33,932.08,175694.60999999993,114243.76000000002,1316.41
203,204.0,382.29,934.12,174762.52999999994,114626.05000000002,1316.41
204,205.0,380.25,936.16,173828.40999999995,115006.30000000002,1316.41
205,206.0,378.2,938.21,172892.24999999994,115384.50000000001,1316.41
206,207.0,376.15,940.26,171954.03999999995,115760.65000000001,1316.41
207,208.0,374.09,942.32,171013.77999999994,116134.74,1316.41
208,209.0,372.03,944.38,170071.45999999993,116506.77,1316.41
209,210.0,369.97,946.44,169127.07999999993,116876.74,1316.41
210,211.0,367.9,948.51,168180.63999999993,117244.64,1316.41
211,212.0,365.82,950.59,167232.12999999992,117610.46,1316.41
212,213.0,363.74,952.67,166281.53999999992,117974.20000000001,1316.41
213,214.0,361.66,954.75,165328.8699999999,118335.86000000002,1316.41
214,215.0,359.57,956.84,164374.1199999999,118695.43000000002,1316.41
215,216.0,357.48,958.93,163417.2799999999,119052.91000000002,1316.41
216,217.0,355.38,961.03,162458.34999999992,119408.29000000002,1316.41
217,218.0,353.28,963.13,161497.31999999992,119761.57000000002,1316.41
218,219.0,351.17,965.24,160534.18999999992,120112.74000000002,1316.41
219,220.0,349.06,967.35,159568.94999999992,120461.80000000002,1316.41
220,221.0,346.94,969.47,158601.59999999992,120808.74000000002,1316.41
221,222.0,344.82,971.59,157632.12999999992,121153.56000000003,1316.41
222,223.0,342.69,973.72,156660.53999999992,121496.25000000003,1316.41
223,224.0,340.56,975.85,155686.81999999992,121836.81000000003,1316.41
224,225.0,338.43,977.98,154710.9699999999,122175.24000000002,1316.41
225,226.0,336.29,980.12,153732.9899999999,122511.53000000001,1316.41
226,227.0,334.15,982.26,152752.8699999999,122845.68000000001,1316.41
227,228.0,332.0,984.41,151770.6099999999,123177.68000000001,1316.41
228,229.0,329.84,986.57,150786.1999999999,123507.52,1316.41
229,230.0,327.69,988.72,149799.6299999999,123835.21,1316.41
230,231.0,325.52,990.89,148810.9099999999,124160.73000000001,1316.41
231,232.0,323.36,993.05,147820.01999999987,124484.09000000001,1316.41
232,233.0,321.18,995.23,146826.96999999988,124805.27,1316.41
233,234.0,319.01,997.4,145831.73999999987,125124.28,1316.41
234,235.0,316.83,999.58,144834.33999999988,125441.11,1316.41
235,236.0,314.64,1001.77,143834.7599999999,125755.75,1316.41
236,237.0,312.45,1003.96,142832.9899999999,126068.2,1316.41
237,238.0,310.25,1006.16,141829.0299999999,126378.45,1316.41
238,239.0,308.05,1008.36,140822.8699999999,126686.5,1316.41
239,240.0,305.84,1010.57,139814.50999999992,126992.34,1316.41
240,241.0,303.63,1012.78,138803.93999999992,127295.97,1316.41
241,242.0,301.42,1014.99,137791.15999999992,127597.39,1316.41
242,243.0,299.2,1017.21,136776.16999999993,127896.59,1316.41
243,244.0,296.97,1019.44,135758.95999999993,128193.56,1316.41
244,245.0,294.74,1021.67,134739.51999999993,128488.3,1316.41
245,246.0,292.51,1023.9,133717.84999999992,128780.81,1316.41
246,247.0,290.27,1026.14,132693.94999999992,129071.08,1316.41
247,248.0,288.02,1028.39,131667.8099999999,129359.1,1316.41
248,249.0,285.77,1030.64,130639.41999999991,129644.87000000001,1316.41
249,250.0,283.52,1032.89,129608.77999999991,129928.39000000001,1316.41
250,251.0,281.26,1035.15,128575.88999999991,130209.65000000001,1316.41
251,252.0,279.0,1037.41,127540.73999999992,130488.65000000001,1316.41
252,253.0,276.73,1039.68,126503.32999999991,130765.38,1316.41
253,254.0,274.45,1041.96,125463.64999999992,131039.83,1316.41
254,255.0,272.17,1044.24,124421.68999999992,131312.0,1316.41
255,256.0,269.89,1046.52,123377.44999999991,131581.89,1316.41
256,257.0,267.6,1048.81,122330.9299999999,131849.49000000002,1316.41
257,258.0,265.3,1051.11,121282.11999999991,132114.79,1316.41
258,259.0,263.01,1053.4,120231.00999999991,132377.80000000002,1316.41
259,260.0,260.7,1055.71,119177.60999999991,132638.50000000003,1316.41
260,261.0,258.39,1058.02,118121.8999999999,132896.89000000004,1316.41
261,262.0,256.08,1060.33,117063.8799999999,133152.97000000003,1316.41
262,263.0,253.76,1062.65,116003.5499999999,133406.73000000004,1316.41
263,264.0,251.43,1064.98,114940.8999999999,133658.16000000003,1316.41
264,265.0,249.1,1067.31,113875.91999999991,133907.26000000004,1316.41
265,266.0,246.77,1069.64,112808.60999999991,134154.03000000003,1316.41
266,267.0,244.43,1071.98,111738.96999999991,134398.46000000002,1316.41
267,268.0,242.08,1074.33,110666.98999999992,134640.54,1316.41
268,269.0,239.73,1076.68,109592.65999999992,134880.27000000002,1316.41
269,270.0,237.38,1079.03,108515.97999999992,135117.65000000002,1316.41
270,271.0,235.02,1081.39,107436.94999999992,135352.67,1316.41
271,272.0,232.65,1083.76,106355.55999999992,135585.32,1316.41
272,273.0,230.28,1086.13,105271.79999999993,135815.6,1316.41
273,274.0,227.91,1088.5,104185.66999999993,136043.51,1316.41
274,275.0,225.53,1090.88,103097.16999999993,136269.04,1316.41
275,276.0,223.14,1093.27,102006.28999999992,136492.18000000002,1316.41
276,277.0,220.75,1095.66,100913.01999999992,136712.93000000002,1316.41
277,278.0,218.35,1098.06,99817.35999999991,136931.28000000003,1316.41
278,279.0,215.95,1100.46,98719.29999999992,137147.23000000004,1316.41
279,280.0,213.54,1102.87,97618.83999999991,137360.77000000005,1316.41
280,281.0,211.13,1105.28,96515.96999999991,137571.90000000005,1316.41
281,282.0,208.71,1107.7,95410.68999999992,137780.61000000004,1316.41
282,283.0,206.29,1110.12,94302.98999999992,137986.90000000005,1316.41
283,284.0,203.86,1112.55,93192.86999999992,138190.76000000004,1316.41
284,285.0,201.43,1114.98,92080.31999999992,138392.19000000003,1316.41
285,286.0,198.99,1117.42,90965.33999999992,138591.18000000002,1316.41
286,287.0,196.54,1119.87,89847.91999999993,138787.72000000003,1316.41
287,288.0,194.09,1122.32,88728.04999999993,138981.81000000003,1316.41
288,289.0,191.64,1124.77,87605.72999999992,139173.45000000004,1316.41
289,290.0,189.18,1127.23,86480.95999999992,139362.63000000003,1316.41
290,291.0,186.71,1129.7,85353.72999999992,139549.34000000003,1316.41
291,292.0,184.24,1132.17,84224.02999999993,139733.58000000002,1316.41
292,293.0,181.76,1134.65,83091.85999999993,139915.34000000003,1316.41
293,294.0,179.28,1137.13,81957.20999999993,140094.62000000002,1316.41
294,295.0,176.79,1139.62,80820.07999999993,140271.41000000003,1316.41
295,296.0,174.3,1142.11,79680.45999999993,140445.71000000002,1316.41
296,297.0,171.8,1144.61,78538.34999999993,140617.51,1316.41
297,298.0,169.3,1147.11,77393.73999999993,140786.81,1316.41
298,299.0,166.79,1149.62,76246.62999999993,140953.6,1316.41
299,300.0,164.27,1152.14,75097.00999999994,141117.87,1316.41
300,301.0,161.75,1154.66,73944.86999999994,141279.62,1316.41
301,302.0,159.23,1157.18,72790.20999999993,141438.85,1316.41
302,303.0,156.7,1159.71,71633.02999999994,141595.55000000002,1316.41
303,304.0,154.16,1162.25,70473.31999999993,141749.71000000002,1316.41
304,305.0,151.62,1164.79,69311.06999999993,141901.33000000002,1316.41
305,306.0,149.07,1167.34,68146.27999999994,142050.40000000002,1316.41
306,307.0,146.52,1169.89,66978.93999999994,142196.92,1316.41
307,308.0,143.96,1172.45,65809.04999999994,142340.88,1316.41
308,309.0,141.39,1175.02,64636.59999999995,142482.27000000002,1316.41
309,310.0,138.82,1177.59,63461.57999999995,142621.09000000003,1316.41
310,311.0,136.25,1180.16,62283.989999999954,142757.34000000003,1316.41
311,312.0,133.66,1182.75,61103.82999999995,142891.00000000003,1316.41
312,313.0,131.08,1185.33,59921.07999999995,143022.08000000002,1316.41
313,314.0,128.48,1187.93,58735.74999999995,143150.56000000003,1316.41
314,315.0,125.89,1190.52,57547.81999999995,143276.45000000004,1316.41
315,316.0,123.28,1193.13,56357.29999999995,143399.73000000004,1316.41
316,317.0,120.67,1195.74,55164.169999999955,143520.40000000005,1316.41
317,318.0,118.06,1198.35,53968.42999999996,143638.46000000005,1316.41
318,319.0,115.43,1200.98,52770.07999999996,143753.89000000004,1316.41
319,320.0,112.81,1203.6,51569.099999999955,143866.70000000004,1316.41
320,321.0,110.17,1206.24,50365.499999999956,143976.87000000005,1316.41
321,322.0,107.54,1208.87,49159.25999999996,144084.41000000006,1316.41
322,323.0,104.89,1211.52,47950.389999999956,144189.30000000008,1316.41
323,324.0,102.24,1214.17,46738.86999999996,144291.54000000007,1316.41
324,325.0,99.59,1216.82,45524.69999999996,144391.13000000006,1316.41
325,326.0,96.92,1219.49,44307.87999999996,144488.05000000008,1316.41
326,327.0,94.26,1222.15,43088.38999999996,144582.31000000008,1316.41
327,328.0,91.58,1224.83,41866.23999999996,144673.89000000007,1316.41
328,329.0,88.9,1227.51,40641.40999999996,144762.79000000007,1316.41
329,330.0,86.22,1230.19,39413.89999999996,144849.01000000007,1316.41
330,331.0,83.53,1232.88,38183.709999999955,144932.54000000007,1316.41
331,332.0,80.83,1235.58,36950.82999999996,145013.37000000005,1316.41
332,333.0,78.13,1238.28,35715.249999999956,145091.50000000006,1316.41
333,334.0,75.42,1240.99,34476.96999999996,145166.92000000007,1316.41
334,335.0,72.7,1243.71,33235.97999999996,145239.62000000008,1316.41
335,336.0,69.98,1246.43,31992.26999999996,145309.6000000001,1316.41
336,337.0,67.26,1249.15,30745.83999999996,145376.8600000001,1316.41
337,338.0,64.52,1251.89,29496.68999999996,145441.3800000001,1316.41
338,339.0,61.79,1254.62,28244.79999999996,145503.1700000001,1316.41
339,340.0,59.04,1257.37,26990.17999999996,145562.2100000001,1316.41
340,341.0,56.29,1260.12,25732.80999999996,145618.50000000012,1316.41
341,342.0,53.53,1262.88,24472.689999999962,145672.03000000012,1316.41
342,343.0,50.77,1265.64,23209.80999999996,145722.8000000001,1316.41
343,344.0,48.0,1268.41,21944.169999999962,145770.8000000001,1316.41
344,345.0,45.23,1271.18,20675.759999999962,145816.03000000012,1316.41
345,346.0,42.45,1273.96,19404.57999999996,145858.48000000013,1316.41
346,347.0,39.66,1276.75,18130.619999999963,145898.14000000013,1316.41
347,348.0,36.87,1279.54,16853.869999999963,145935.01000000013,1316.41
348,349.0,34.07,1282.34,15574.329999999962,145969.08000000013,1316.41
349,350.0,31.26,1285.15,14291.989999999962,146000.34000000014,1316.41
350,351.0,28.45,1287.96,13006.839999999962,146028.79000000015,1316.41
351,352.0,25.64,1290.77,11718.879999999961,146054.43000000017,1316.41
352,353.0,22.81,1293.6,10428.10999999996,146077.24000000017,1316.41
353,354.0,19.98,1296.43,9134.50999999996,146097.22000000018,1316.41
354,355.0,17.15,1299.26,7838.07999999996,146114.37000000017,1316.41
355,356.0,14.3,1302.11,6538.81999999996,146128.67000000016,1316.41
356,357.0,11.46,1304.95,5236.70999999996,146140.13000000015,1316.41
357,358.0,8.6,1307.81,3931.75999999996,146148.73000000016,1316.41
358,359.0,5.74,1310.67,2623.9499999999603,146154.47000000015,1316.41
359,360.0,2.87,1313.54,1313.2799999999602,146157.34000000014,1316.41
